     #######
   ###     ###
  ##  $ $ $ @##
 ##    $ $    ##
 #  $  .*.  $  #
##    .   .    ##
# $  .     .  $ #
#  $.  ...  .$  #
# $ *  .*.  * $ #
#  $.  ...  .$  #
# $  .     .  $ #
##    .   .    ##
 #  $  .*.  $  #
 ##    $ $    ##
  ##  $ $ $  ##
   ###     ###
     #######
