########
#.    .#
#@$$$$ #
#.    .#
########
