 #######
 #.   .#
###$ $###
#.$ $ $.#
#..$@$..#
#.$ $ $.#
###$ $###
 #.   .#
 #######
