  ####
  #..#
###..###
# $  $@#
# $$$$ #
#.    .#
########
