###########
#.       .#
#  . $ .  #
# .$* *$. #
#  * $ *  #
# $ $@$ $ #
#  * $ *  #
# .$* *$. #
#  . $ .  #
#.       .#
###########
