####
#@ ##
# $ ##
#$   #######
#.# $ $ $ .#
###    $  .#
  #   $   ##
  #  ###  #
  #..# #..#
  #### ####
