    ######
    #....#
    #....#
    #....#
   ###..###
  ##@$$$$ ##
 ##  $  $  ##
 #    $ $   #
 #$ $  $   $#
##    $     ##
#.$     $  $.#
#.$        $.#
#.  $    $  .#
##############
