#########
#.     .#
# # * # #
#   $   #
#  $@$  #
#   $   #
# # * # #
#.     .#
#########
