#######
#.   .#
#  $  #
# $@$ #
#  $  #
#.   .#
#######
