      #####
      #   #
   #### $ ####
   # $  $$ $ #
#### $     $ ####
#    .......    #
# $$ ...@... $$ #
# $  .......  $ #
#### $     $ ####
   # $ $$  $ #
   #### $ ####
      #   #
      #####
