      ######
      #    ##
   #####$$  ############
  ##...#  $  $    $    ###
 ##.....$     $    $   $ ###
##...... $$$   $$   $   .*+###
 ##.....$     $    $   $ ###
  ##...#  $  $    $    ###
   #####$$  ############
      #    ##
      ######
