###########
#..  #  ..#
#..  $  ..#
#  $ $ $  #
#.  $$$$ .#
##$ $@$ $##
#. $$$$  .#
#  $ $ $  #
#..  $  ..#
#..  #  ..#
###########
