 #####
##. *##
#.$$ .#
#$@ $ #
#.$$$.#
##. .##
 #####
