#########
#.##.##.#
#   .   #
#$ $$$  #
#. $@$ .#
#  $$$ $#
#   .   #
#.##.##.#
#########
