 #########
##.  $  .##
#.  .*.  .#
#*$$$$$$$*#
#.   $@  .#
##.  $  .##
 #########
