    ###
    #@#
   ## ##
   #   #
  ##$$$##
  #     #
 ##$$ $$##
 #       #
##$  $  $##
#   $ $   #
#  $ $ $  #
#.  $ $  .#
##.......##
 ##.....##
  ##...##
   #####
