   ###   ###
  ##.## ##.##
 ## $ ### $ ##
##.$ $.#.$ $.##
#.$     $@. $.#
##.$ $.#.$ $.##
 ## $ ### $ ##
  ##.## ##.##
   ###   ###
