#########
#.##.##.#
#       #
#  $$$  #
#. $@$ .#
#  $$$  #
#       #
#.##.##.#
#########
