#######
#. $..#
#. $  #
#$$#$$#
# @$ .#
#..$ .#
#######
