#############
#.   $@$   .#
##. $$$$$ .##
 ##. $ $ .##
  ##.$ $.##
   ##. .##
    ##.##
     ###
