#######
#. . .#
#  $  #
#$$@$$#
#  $  #
#. . .#
#######
