       ######
########....#
#     ##  @.#
# $ $ ##$$ .#
## #     $ .#
 # $ $    $.#
 #   ########
 #####
