###########
#..  $  ..#
#.. $ $ ..#
#  . $ .  #
# $ @$  $ #
#$ $$ $$ $#
# $  $  $ #
#  . $ .  #
#.. $ $ ..#
#..  $  ..#
###########
