###############
#@            #
# $    *    $ #
#  $ #...# $  #
# $ $.#.#.$ $ #
# $ ...#... $ #
# $ $.#.#.$ $ #
#  $ #...# $  #
# $    *    $ #
#             #
###############
