#########
#@  #  .#
# $ #$$ #
#  . .  #
### # ###
#  . .  #
# $$#$$ #
#.  #  .#
#########
