################
#..$  $ @$  $..#
#..$  $  $  $..#
#..$  $  $  $..#
#..$  $  $  $..#
#..$  $  $  $..#
################
