#########
##. . .##
# #$ $# #
#.$ $ $.#
#. $@$ .#
#.$ $ $.#
# #$ $# #
##. . .##
#########
