#################
#@  ##    ##....#
# $ ## $$ ##.$ .#
#  $ $   $  $ $.#
# $ ## $$ ##.$ .#
#   ##    ##....#
#################
