####            ####
#  ##############  #
# $              $ #
#   $*.*.*.*.*.$ $ #
# $ $.*.*.*.*.*$   #
# $              $ #
#  ##############@ #
####            ####
