#######
#.....#
#$ $ $#
# $$$ #
# .@. #
# $$$ #
#$ $ $#
#.....#
#######
