####     ####
#..#######..#
#.$ $ $ $ $.#
#     #     #
#     $     #
# . $#.#$ . #
# #$ .*. $# #
# . $#@#$ . #
#     $     #
#     $     #
#.$ $ $ $ $.#
#..#######..#
####     ####
