#########
#@  #   #
# $ # $ #
#  . .  #
### # ###
#  . .  #
# $ # $ #
#   #   #
#########
