#########
##. . .##
#.#  $#.#
# $$$$  #
#. $@$ .#
#  $$$$ #
#.#$  #.#
##. . .##
#########
