#########
#.......#
#.$ $ $ #
#$ $ $ $#
# $ @ $ #
#$ $ $ $#
# $ $ $.#
#.......#
#########
