###########
#..  #  ..#
#..  $  ..#
#  $ $ $  #
#   $$$   #
##  $@$  ##
#   $$$   #
#  $ $ $  #
#..  $  ..#
#..  #  ..#
###########
