########
#.  @ .#
#*$$$$*#
#.    .#
########
