#########
#.. $ ..#
#.  $  .#
#  $ $  #
#$$ @ $$#
#  $ $  #
#.  $  .#
#.. $ ..#
#########
