     ####
    ## .##
   ## $  ##
  ## $  $ ##
 ## $    $ ##
## $ .... $ ##
#    .#..  $ #
# $  ..#.   @#
## $ .... $ ##
 ## $    $ ##
  ## $  $ ##
   ##  $ ##
    ##. ##
     ####
