  #######
  #     #
  # $   #
  # $ $$######
### $     $ @#
#.. $$ ## $  #
#..$$  ## $$$#
#......##....#
##############
