####
#..################
#           ...  @#
#    $$ $. $.*.$  #
# $#  $      $ #$ #
#  # $  *.*$   #  #
# $# # *.*..$#$#$ #
#  #$# ..... # #  #
#  #   *..*.   #  #
#  #$   ... $  #  #
#  $  $$$      $  #
#                 #
###################
