##########
#  $..$  ##
#  $..$   #
#  $..$   #
#  $..$  @#
###########
