#########
##. . .##
#..$$$..#
# $$ $$ #
#.$ @ $.#
# $$ $$ #
#..$$$..#
##. . .##
#########
