#######
#.   .#
#.$$$.#
##$@$##
#.$$$.#
#.   .#
#######
