#####           #####
#   ### ##### ###   #
# .$  ###. .###  $. #
# $ . $ #   # $ . $ #
## .  .       .  . ##
 #   $  $# #$  $   #
 ##  . . # # . .  ##
  ##  $  # #  $  ##
   ##  . # # .  ##
    ##   # #   ##
   ####$$#$#$$####
  ##     # #     ##
  #  . $ # # $ .  #
  # .$.  # #  .$. #
  # $.    $    .$ #
  ##    #   #    ##
   #######@#######
         ###
