#######
#..  .#
#$ $ *#
#@$ $ #
#* $ $#
#.  ..#
#######
