###########
#.       .#
#. $$$$$ .#
## $...$ ##
## $...$ ##
#. $$$$$ .#
#.   @   .#
###########
