#############
#  #     #..#
# $#@ $ $#..#
# $ $ # $ .*#
#     # $ ..#
#############
