#########
##. $@.##
#.. $ ..#
#  $ $  #
#$$   $$#
#  $ $  #
#.. $ ..#
##. $ .##
#########
