     #####
    ##...##
#####..*..#####
#     $ $     #
# $$$$$*$$$$$ #
#     $@$     #
#####..*..#####
    ##...##
     #####
