     #
    ### ##
   ## ####
  ##   #@#
 ## $.$  #
## $ * $ ##
#         #
## ..$.* ##
 # *.$*. #
 #  $    #
 # $  $  #
 # * .*$ #
 # .$..$ #
 #   ..  #
 #########
