 ####
 #. #######
 #$     $.#
 # $   $ @#
 #  *.*  ##
 #  .*.  #
##  *.*  #
#  $   $ #
#.$     $#
####### .#
      ####
