       #
      ###
     ##.##
    ## @ ##
   ##  $  ##
  ##.$.$.$.##
   ##  $  ##
  ##   $   ##
 ##.$.$.$.$.##
  ##   $   ##
 ##         ##
##.$.$.$.$.$.##
######   ######
     #####
