     ####
    ##..##
   ##    ##
  ## $ $$ ##
 ## $  $ $ ##
## $ ..*.   ##
#    .#.. $  #
#  $ ..#.   @#
##   .*.. $ ##
 ## $ $  $ ##
  ## $$ $ ##
   ##    ##
    ##..##
     ####
